0011101000111010
0110001110101010
1101001000111111
0011100110001110
1101100110110010
0100001100011001
1101011001011011
1101001010110001
0111000000001001
1101011010110010
1000011100100100
0110110100011110
1011001001110011
1000000011001111
1100011111111111
1101101110010000
