0000110011101011
0110000111001011
1010010100011001
1011000001111001
1100011100001111
0101010101100010
1101100100100101
0111001110100101
0001001000100001
0011011011011000
0111001010011110
1000100001000000
0101011001010101
0100010011101101
1110011111010000
0001101011011100