0111100010101010
0000000101100101
1111000110111010
0001010100011110
1100110110011000
1111010011000001
1001100000010101
1100001111010011
1011010110011100
1010010111011110
0101000111001001
1100110000100110
0001011100100001
1010100100010001
0111110110100000
0110100110000010
