0011000100000100
0000000000011011
0011101100011111
1111010100101010
1000111001101101
0110101000010001
1101010010100000
0000010100100101
0010001000011110
1110011110101011
1011010010111001
0010001000000000
0000010101111101
1101110101011001
1111101101010101
0010111101011000
